11111111111111111111111111111111111111111111111111111111111111111111111111111111111111111111111111111111111111111111111
10000000000000000000000000000000000000000000000000000000000000000000000000000000000000000000000000000000000000000000001
10000000000000000000000000000000000000000000000000000000000000000000000000000000000000000000000000000000000000000000001
10000000000000000000000000000000000000000000000000000220000000000000000000000000000000000000000000000000000000000000001
10000000000000000000000000000000000000000000000000000220000000000000000000000000000000000000000000000000000000000000001
10000000000000000000000000000000000000000000000000000220000000000000000000000000000000000000000000000000000000000000001
10000000000000000000000006000000000000000000000000000220000000000000000000000000000000000000060000000000000000000000001
10000000000000000000000000000000000000000000000000000220000000000000000000000000000000000000000000000000000000000000001
10000000000000000000000000000000000000000000000000000220000000000000000000000000000000000000000000000000000000000000001
10000000000000000000000000000000000000000000000000000000000000000000000000000000000000000000000000000000000000000000001
10000000000000000000500000000000000000000000070000000000000000000000000000000000000000000000000000000000000000000000001
10000000000000000022222000000000000000000222222200000000000000000006000000000000000000000000000000023432100000000000111
10000000000000000022222000000000000000000222222200000000000000000000000000000000000000000000000000000000000000000000001
10000000000000000000000000000000000000000000000000000000000000000000000000000000000000000000000000000000000000000000001
10000000000000000000000000000000000000000000000000000000000000000000000000000070000000000000000000000000000000000000001
10000000000000000000000000006000000000000000000000000003333333333320000004444444444000000000000000000000000000000000001
10000000000000000000000000000000060000000000000000000003333333333300000004444444444000000003000000000000000000000000001
10000000000000000600000000000000000000000000000070000000000000000000000000000000000000000003000000000000000000000000001
10000000000000000000000000000000000000000044444444444000000000000000000000000000060000000003000000000000000000000000001
10000000000000000000000000000000000000000000000000000000000000000000000000000000000000000003000000000000000000000000001
10000000000000000000000000000000000000000000000000000000000000000000000000000000000000000003000000000000000000000000001
10000000000000070000000000000000000000000000000000000000000000000000000000000000000000000003000000000000000000000000001
10000000111111111111111111000000000000000000000000000600000000000000000222222222220000000003000000000000000000000000001
10000000111111111111111111000000000000000000000000000000000000000000000000000000000000000003000000000000000000000000001
10000000000000000000000000000000000000000600000000000000000000000000000000000000000000000003000000000000000000000000001
10000000000000000000000000000000000000000000000000000000000000000000000000000000000000000003000000000000000000000000001
10000000000000000000000000000000000000000000000000000000000000000000000000000000000000000003000000000000000000000000001
10000000000000000000000000000000000000000000000000000000000000000000000000000000000000000000000000000000000000000000001
10000000000000000000000000000000000000000000000000000000000070000000000000000000000007000000000000000000000000000000001
10000000000000000000000000700000000000000000000000000000000222222222240000000000004444444400000000000000000000000000001
10000000000000000000000000111111110000000000000000000000222222222200000000007000000000000000000000000000000000080000001
10000000000000070000000000000000000000000000000000000000000000000007003333333333333330000000000000000000000011111111111
11111111111111111111111111111111111111111110011111111111111111111111111111111111111111111111111111111111111111111111111