111111111111111111111111111111111111111111111111111111111111111111111111111111111111111111111111111111111111111111111111111111111111111111111111111111111111111111111111111111111111111111111111111111111111111111111111111111111111111111111111
1                                                                                                    8                                                                                                                                         1
1                                                                                                                                                                                                                                              1
1                                                                                                                                                                                                                                              1
1                                                                                                                                                                                                                                              1
1                                                                                                                                                                                                                                              1
1                                                                                                                                                                                                                                              1
1                                                                                                                           444444444444444444444444444                                                                                        1
1                                                                                                                                                                                                                                              1
1                                                                                                                                                                                                                                              1
1                                                                                           22222222222222222222                                                                                                                               1
1                                                                                                                                                                                                                                              1
1                                                               6                                                                                                                                                                              1
1                                                                                                                                                                                                                                              1
1                                                                                                 3                                                                                                                                            1
1                                                                                                 3                                                                                                                                            1
1                                                                                                 3                                 7                                                                                                          1
1                                           7                                                     3                   333333333333333333333333                                                                                                 1
1                            2222222222222222222222222222222                                      3                                                                                                                                            1
1                                                                                                 3                                                                                                                                            1
1                                                                                                 3                                                                                                    22222222222222222222444443 43 326234 3  1
1                                                                                                 3                                                             6                                                                              1
1                                                                                                 3                                                                                                                                            1
1                                                                                                 3                                                                                                                                            1
1                                                                   7                             3                                                                                      3                                                     1
1                                               1111111111111111111111111111111                   3                                                                                                                                            1
1                                                                                                 3                                                                                                                                            1
1                                                                                                 3                                                                                                                                            1
1                                                                                                 3                                                                                                                                            1
1                                                                                                 3                                                       7                                                                                    1
1                                                                6             6                  3                                       44444444444444444444444444444444444                                                                  1
1                      6                                                                          3   6                                                                     4                                                                  1
1                                                                                                 3                                                                         4                                                                  1
1                                                                         6                       3                                                                         4                               6                                  1
1                                                                  6      6                       3                                                                         4                                                                  1
1                                                                 6             6                               7                                                           4                                                                  1
1                                                              6                   44444444444444444444444444444444444                                                      4                                                                  1
1                                                                                                                                                                           4                                                                  1
1                                                                                                                                                                           4444                                                               1
1                                                                                                                                                                           4                                                                  1
1                                                                                                                                                                           4                                                                  1
1                                   11111111111111111111                                                                                             7                      4                                                                  1
1                                                                                                                                           444444444444                    4                                                                  1
1                                                                                                                                                                           4                                                                  1
1                                                                                                                                                                                         4                                                    1
1                                                                                           6666666666                                                                                                                                         1
1                                                                                                                                                                                                                                              1
1                                                                                                                                                                                                                                              1
1                                                                                                                                                                                                                                              1
1                                                                                                                                                                                                         444444444                            1
1                                                                                                                                                                                               4                                              1
1                    11111111111111111111                                                                                                                                                                                                      1
1                                        11111111111111111111                                                                                                                                                                                  1
1                                                            11111111111111111                                                                                                                                                                 1
1                                                                             1111111111111111                                                                                                                                                 1
1                                                                                             1111111111111                                                                                                                                    1
1                                                                                                                                                                                      7                                                       1
1                                                                                                          1111111111111                                                            111111                                                     1
1                                                                                            11111111111111                                                                                                                                    1
1                                                                              11111111111111                                                                                                                                                  1
1                                                                                                                                                                                                                                              1
1                                                                                                                                                                          4                                                                   1
1                                                                                                                                                                                                                                              1
1                                                                                                                                                                                                                                              1
1                                                                                                                                                              5                                                                               1
1111111111111111111111111111111111111111111  111111111111111111111111111111111111111111111111111111                           121                           111111  11111111111111111111                                              1111111111