111111111111111111111111111111111111111111111111111111111111111111111111111111111111111111111111111111111111111111111111111111111111111111111111111111111111111111111111111111111111111111111111111111111111111111111111111111111111111111111111
1                                                                                                                                                                                                                                              1
1                                                                                                                              6                                                                                                               1
1                                                                                                                                            6                                                                                                 1
1                                                                                                                                    6                                                                                                         1
1                                                                                                                                6               6               6                                                          6                  1
1                                                                                                                               7       7   7     7 7                        6                                   6                             1
1                                                                                                                           444444444444444444444444444                               66                 6                                     1
1                                                                                                                                                                   6666                           6                                           1
1                                                                                                                                                                                             6             6        6                         1
1                                                                                                                                                                                4                           6                                 1
1                                                                                                        4                                                                                        6                                            1
1                                                               6                                                   6                                             6                    4   6            6       6     3                        1
1                                                                                                                                                                   6                                                33                        1
1                                                                                                                                                                     6                              6              333           6            1
1                                                                                                 3                  4                                                 6 66                                    6   3333                        1
1                                                                                                           6                   6   6                  6                   6 6 6                                  33333         6              1
1                                           7                                                                                                                                                                    333333                        1
1                            2222222222222222222222222222222                                                                                                                                     6              3333333 6             5        1
1                                                                                                 6                                                                                             6              33333333              6         1
1                                                                                                                               6           6                                                                  4444444444444444444444444444444 1
1                                                                                                 3                                                             6                            66                                                1
1                                                                                                 3          4                                                                                                                                 1
1                                                                                                 3                                                                                                                                            1
1                                                                   7                                                                                   6                                3                                                     1
1                                               1111111111111111111111111111111                                                 6   4                                                                                                          1
1                                                                                                                                                                                                                                              1
1                                                                                                                                              6              6                                                                                1
1                                                                                                 3                                                                                                                                            1
1                                                                                                 3                        3                              6              6                            7                                        1
1                                                                6             6                  3                        333333333333333                                  4                         4                                        1
1                      6                                                                              6                   3     3333333333333333333333                      4                                                                  1
1                                                                                                 3                      3      33333333333333333     33                    4                                                                  1
1                                                                         6                       3                      3   6  3333333333333333       33                   4                               6                                  1
1                                                                  6      6                                            33                                33                 4                                                                  1
1                                                                 6             6                               7     3                              6    33                4                                                                  1
1                                                              6                                                     3   6            7          6         33               4        7                                                         1
1                                                                                                                    3         33333333                 6   33              4        4         7                                               1
1                                                                                                                   3          33333333333       6 6         33             4444         6     4    6     7                                    1
1                                                                                                                  3        333333333333333          6        33            4                             4    6                               1
1                                                                                                                 3            3333333333333           6       33           4                                                                  1
1                                                                                                                3             33333333333333   7    7      6  33           4     6                                   7                        1
1                                                                                                               3              3333333333333333333333333333333334           4                   6                     4                        1
1333333333333333333333333333333333333333333333333333333333333333333333333333333333333333333333333333333333333333333      6     3                                            4             7                                                    1
1                                                                                                                 2            2                                                          4            7                                       1
1                                                                                                                 2            2                                                                       4                                       1
1                                                                                                         6       27 7      6  2                                                                              6                                1
1                                                                                           6                     222          2                                                                                                               1
1                                                                                                                 2            2                                                     6                           7                             1
1                                                                                                     6           2     6    7 2                                    6                         7                4444                            1
1                        7      777  7                                                                                       222                                                              4                                                1
1                  2222222222222222222222       7    7                                                                         2                                                 7                                                             1
1        6        2                      22222222222222222222777                 7 7 7     7     7           7                 2                                                 4      6                                                      1
1                2                                           222           222222222222222222222222222222222222222222222222222  2                                       7                                                                      1
1               2                                              2           2                                                  2222                                6     4                    6                                                 1
1 8           22                                               2           2                                                                                                                                                                   1
1            22                                                2           2                             6                                                                     6       7                                                       1
1222222222222                                                  2           2                              6                                           4444444                       111111                                                     1
1                                                              2           22222222222222222222222222222   6     44444444444444444444444444          4                7                                                                        1
1                                                              2                                            6                              4        4          7      4                                                                        1
1                                                              2                  6 6 6 6  6 6               6                              44444444           4           7                                                                   1
1                                                              2                                              6      7       7                                             4                                                                   1
1                                                              2           2222222222        22222222222       6 4444444444444      4444444  6    6    444444                                                                                  1
1                                                              2           2        2        2                  6                         444        444                                                                                       1
1                                                              2           2        2        2                                              444444444                                                                                          1
1                                                              2           2        2        2                                                                                                                                        1111111111